NO ./textures/purpletile.xpm
SO ./textures/lightwood.xpm
WE 		 ./textures/purplebrick.xpm
EA 		./textures/lightstone.xpm

F 		 	 		  87,33,98
C 104,63,199

SO ./textures/lightwood.xpm



1111111111111111111111111
1000000000110000000000001
1011000001110000000000001
1001000000000000000000001
1111111110110000011100001
100000000011000001110111111111111
11110111111111011100000010001
11110111111111011101010010001
11000000110101011100000010001
10000000000000001100000010001
10000000000000001101010010001
11000001110101011111011110N0111
11110111 1110101 101111010001
11101111 1111111 111111111111
