NO ./textures/purpletile.xpm
SO ./textures/lightwood.xpm
WE ./textures/purplebrick.xpm
EA ./textures/lightstone.xpm

F 87,33,98
C 104,63,199

1111111111111111111
10000000110000N00001
1001110000001110101
111000000000000011
1000000010000001111
111111111111111
