NO ./textures/wall_01.xpm
SO ./textures/wall_02.xpm
WE ./textures/3_48.xpm
EA ./textures/4_48.xpm

F 87,33,98
C 104,63,199

1111111111111111111111111
1000000000110000000000001
10110000011100000F0000001
1001000000000000000000001
1111111110110000011100001
100000000000000001110111111111111
1111D111111111D11100000010001
111101111111110111010100D0001
11000000110101011100000010001
10F0000000000000D000000010F01
100000000F0000001101010010001
11000001110101011111011110N0111
11110111 1110101 101111010001
11111111 1111111 111111111111